....................
....................
....................
....................
...XXXXXXX..........
...X................
...X................
...X................
...X................
...X................
...X................
...X................
...X................
...X................
.......XXXXX........
....................
....................
....................
....................
....................