XXXXXXXXXXXXXXXXXXXX
X..................X
X.XXXXXXXXXXXXXXX.X
X.X...............X
X.X.XXXXXXXXXXXXX.X
X.X.X.............X
X.X.X.XXXXXXXXXXX.X
X.X.X.X...........X
X.X.X.X.XXXXXXXXX.X
X.X.X.X.X.........X
X.X.X.X.X.XXXXXXX.X
X.X.X.X.X.X.......X
X.X.X.X.X.X.XXXXX.X
X.X.X.X.X.X.X.....X
X.X.X.X.X.X.X.XXX.X
X...X...X...X...X.X
XXXXXXXXXXXXX.XXX.X
X.............X...X
X.XXXXXXXXXXXXX.XXX
XXXXXXXXXXXXXXXXXXXX